R 500 500
SO ./resource/otherwall/blue_stone.xpm
WE ./resource/otherwall/bookshelf.xpm
EA ./resource/otherwall/gold.xpm
S ./resource/barrel.xpm

NO ./resource/wall/wall_1.xpm

F 0,255,0

C 225,30,0

1 1 1 1 1 1 1
1 0 0 0 0 0 1
1 1 0 0 0 0 1
1 0 0 0 0 0 1
1 1 0 0 2 0 1
1 0 0 0 0 0 1
1 1 0 0 0 0 1
1 0 0 0 0 0 1
1 1 0 0 2 0 1
1 0 0 0 0 0 1
1 1 0 N 0 0 1
1 0 0 0 0 0 1
1 1 0 0 0 0 1
1 0 0 0 0 0 1
1 1 0 0 0 0 1
1 1 1 1 1 1 1







