R 500      500

SO ./resource/otherwall/blue_stone.xpm
WE ./resource/otherwall/bookshelf.xpm
EA ./resource/otherwall/gold.xpm
NO ./resource/wall/wall_1.xpm
S ./resource/hitler.xpm

F 255,0,0

C 225,0,255

1 1 1 1 1 1 1 1 1 1 1 1 1 1 1 1
1 0 0 0 0 0 0 0 0 0 0 0 0 0 0 1
1 0 0 0 0 0 0 0 0 0 0 0 0 0 0 1
1 1 0 0 2 0 1 1 1 1 1 0 0 0 0 1
1 0 0 0 0 0 1 1 1 1 1 0 0 0 0 1
1 1 0 0 0 0 1 1 1 1 100 0 0 1
1 0 0 0 0 0 0 1 1 1 1 0 0 0 0 1
1 1 0 0 0 0 1 1 1 1 1 0 0 0 0 1
1 1 0 0 0 0 1 1 1 1 1 0 0 0 0 1
1 1 0 0 0 0 1 1 1 1 1 0 0 0 0 1
1 1 0 0 0 0 1 1 1 1 1 0 0 0 0 1
1 0 0 0 0 0 0 0 0 0 0 0 0 0 0 1
1 0 0 0 0 0 0 0 0 0 0 0 0 0 0 1
1 1 0 0 0 0 1 1 1 1 1 0 0 0 0 1
1 1 0 0 2 0 1 1 1 1 1 0 0 0 0 1
1 0 0 0 0 0 0 0 0 0 0 0 0 0 0 1
1 0 0 N 0 0 0 0 0 0 0 0 0 0 0 1
1 0 0 0 0 0 0 0 0 0 0 0 0 0 0 1
1 0 0 0 0 0 0 0 0 0 0 0 0 0 0 1
1 1 1 1 1 1 1 1 1 1 1 1 1 1 1 1






